1111111111111111111111111111
10CCCCCCCCC01000000000000001
1000000000001000000000000001
1000000000001000000000000001
10000000000000000E0000000001
1111111111110000000000000001
1000000000000000000000000001
10000000000000000P0000000001
1000000011110000000000000001
1000000010000000000000000001
1000000000000000000000000001
1000000011111000000000000001
1000000000000000000000000001
1111111111111111111111111111
