111111111111111111111111111111
1P0000000000000000000000000001
101111111111110000000011101001
100000000000100000110000000001
100000000000000000110000000001
100000000001010000000100000001
101111110001110110000100100001
100010000000100000000111110001
101111110000100000000100000001
101E00010000100000010000000001
101000010000100111111110000001
101000010000100000000000000001
1010000100C0100111111110000001
100000000000100000000010000001
100010110000100110000110000001
1000001100001000000G0000000001
100000000000100000000000000001
111111111111111111111111111111
