111111111111111111111111111111
1PCCCCCCCCCCCCCCCCCCCCCCCCCCC1
1C111111111111CCCCCCCC111CCCC1
1CCCCCCCCCCCCCCCCC11CCCCCCCCC1
1CCCCCCCCCCCCCCCCC11CCCCCCCCC1
1CCCCCCCCCC1CCCCCCCCC1CCCCCCC1
1C111111CCC111C11CCCC1CC1CCCC1
1CCCCCCCCCCCCCCCCCCCC11111CCC1
1C111111CCCC1CCCCCCCC1CCCCCCC1
1C1ECCC1CCCC1CCCCCCCCCCCCCCCC1
1C1CCCC1CCCC1CC11111111CCCCCC1
1C1CCCC1CCCC1CCCCCCCCCCCCCCCC1
1C1CCCC1CCCC1CC11111111CCCCCC1
1CCCCCCCCCCC1CCCCCCCCCCCCCCCC1
1CCCCC11CCCC1CC11CCCC11CCCCCC1
1CCCCC11CCCC1CCCCCCCCCCCCCCCC1
1CCCCCCCCCCC1CCCCCCCCCCCCCCCC1
111111111111111111111111111111
