11111111111111111111111111
10000000000011000000000001
10111101111011011110111101
1011110111101P011110111101
10111101111011011110111101
10000000000000000000000001
10111101011111111010111101
10000001000011000010000001
11111101111011011110111111
11111101000C00000010111111
11111101011100111010111111
1E0000000100000010000000E1
11111101011111111010111111
11111101000000000010111111
11111101011111111010111111
10000000000011000000000001
1011110111101G011110111101
10001100000000000000110001
11101101011111111010110111
10000001000011000010000001
10111111111011011111111101
10000000000000000000000001
11111111111111111111111111
