11111111111111111111111111
10000000000011000000000001
10111101111011011110111101
10111101111011111101111011
10111101111011011110111101
10000000000000000000000001
10111101011111111010111101
10000001000011000010000001
11111101111011011110111111
11111101000000000010111111
11111101011100111010111111
10000000010000001000000001
11111101111111111010111111
11111101000000000010111111
11111101110111111010111111
10000000000011000000000001
1011111111111C001110111101
10001111000011100C00110001
111011E1000111111010110111
10000000000P00000010000001
10111111111011011111111101
1000000000000100C000000001
11111111111111111111111111
